

F 125, 125, 125
C 150, 200, 220

NO textures/wall_1.xpm
SO textures/wall_2.xpm
WE    textures/wall_3.xpm
EA textures/wall_4.xpm

111111
100101
101001
1100N1
111111
