NO
SO
WE
EA

F
C

111111111111
1         11
1          1
111111111111
10S000000001
111111111111
11         1
111111111111
