NO
SO
WE
EA

F
C


1111111111
1000000001
1111000001
1000000001
100N001001
101000100111111111
100000100000000001
10000000001000E001
111111111111111111
