


111111
100101
1010x1
1100N1
111111
