NO
SO
WE
EA

F
C

111111
111111
