111111
1001N1
101001
1100N1
111111
