NO //remove .xpm
SO
WE
EA
EA

F
C

111111
100101
101001
1100N1
111111
