NO
SO
WE
EA

F
C

11S111
100101
101001
110001
111111
