NO ./textures/NO_texture.xpm
SO		./textures/SO_texture.xpm
WE  ./textures/WE_texture.xpm
EA ./textures/EA_texture.xpm

F 255, 0, 20
C    150, 200, 220

11S111
100101
101001
110001
111111
