NO
SO
WE
EA

F
C

11111111111111111111111111111111111111111111111111111111111111111111111111111111
10000000000000000000100000000000000000000000000000000000000000000000000000000001
10000S00011000000000100000000000000000000000000000000000000000000000000000000001
10000000111000000000100000000000000000000000010000000000000000000000000000000001
11111111111011111111100000000000001000000000010000000000000000000000000000000001
10000000000000000000100000000000001000000000010000000000000000000000000000000001
10000000000000000000100000000000001000000000010000000000000000000000000000000001
10000000000000000000100000000000001000000000010000000000000000000000000000000001
10000000000000000000100000000000001000000000010000000000000000000000000000000001
10000000000000000000100000000000001000000000010000000000000000000000000000000001
10000000000000000000100000000000001000000000010000000000000000000000000000000001
10000000000000000000100000000000001000000000000000000000000000000000000000000001
10000000000000000000111111111111111000000000000000000000000000000000000000000001
10000000000000000000000000000000000000000000000000000000000000000000000000000001
10000000000000000000000000000000000000000000000000000000000000000000000000000001
10000000000000000000000000000000000000000000000000000000000000000000000000000001
10000000000000000000000000000000000000000000000000000000000000000000000000000001
10000000000000000000000000000000000000000000000000000000000100000000000000000001
10000000000000000000000000000000000000000000000000000000000000000000000000000001
10000000000000000000000000000000000000000000000001000000000000000000000000000001
10000000000000011111111110011111111100000000000000000000000000000000000000000001
10000000000000010000000000000000000100000000000000000000000000000000000000000001
10000000000000010000000111110000000100000000000000000000000000000000000000000001
100000000000000100000001   10000000100000000000000000000000000000000000000000001
100000000000000100000001   10000000100000000000000000100000000000000000000000001
10000000000000010000000111110000000100000000000000001110000000000000000000000001
10000000000000010000000000000000000100000000000000000100000000000000000000000001
10000000000000011111111111111111111100000000000000000000000000000000000000000001
10000000010111110000000000000000000000000000000000000000000000000000000000000001
10000000010000000000000000000000000000000000000000000000000000000000000000000001
10000000010000000000000000000000000000000000000000000000000000000000000000000001
10000000010000000000000000000000000000000000000000000000000000000000000000000001
10000000010000000000000000000000000000000000000000000000000000000000000000000001
10000000010000000000000000000000000000000000000000000000000000000000000000000001
10000000010000000000000000000000000000000000000000000000000000000000000000000001
10000000010000000000000000000000000000000000000000000000000000000000000000000001
11111111111111111111111111111111111111111111111111111111111111111111111111111111
