NO textures/wall_1.xpm
SO textures/wall_2.xpm
WE    textures/wall_3.xpm
EA textures/wall_4.xpm

F 255, 0, 20
C    150, 200, 220

1111111111
1000000001
1111000001
1000000001
100N001001
101000100111111111
100000100000000001
10000000001000E001
111111111111111111
