NO ./textures/NO_texture.xpm
SO		./textures/SO_texture.xpm
WE  ./textures/WE_texture.xpm
EA ./textures/EA_texture.xpm



1111111111
1000000001
1111000001
1000000001
100N001001
1010001001
1000001001
1000000001
1111111111
